"a" = (/turf/wall,/area)
"b" = (/turf/foundation,/area)
"c" = (/turf/floor,/area)
"d" = (/mob/Player,/turf/floor,/area)

(1,1,1) = {"
aaaaaaaaaa
abbbbbbbba
acccccccca
acccccccca
accdccccca
acccccccca
acccccccca
acccccccca
acccccccca
aaaaaaaaaa
"}
